maze1 = [
    ["#", "#", "#", "#", "#", "#", "#", "#", "#"],
    ["o", " ", " ", " ", "#", " ", " ", " ", "#"],
    ["#", " ", "#", " ", "#", " ", "#", " ", "#"],
    ["#", " ", "#", " ", " ", " ", "#", " ", "#"],
    ["#", " ", "#", "#", "#", "#", "#", " ", "#"],
    ["#", " ", " ", " ", " ", " ", " ", " ", "#"],
    ["#", "#", "#", "#", "#", "#", "#", " ", "#"],
    ["#", " ", " ", " ", " ", " ", " ", " ", "#"],
    ["#", "#", "#", "#", "#", "#", "#", "x", "#"]
]



maze2 = [
    ["#", "#", "#", "#", "#", "#", "#", "#", "#"],
    ["#", " ", " ", " ", "#", " ", " ", " ", "o"],
    ["#", " ", "#", " ", "#", " ", "#", " ", "#"],
    ["#", " ", "#", " ", " ", " ", "#", " ", "#"],
    ["#", " ", "#", "#", "#", "#", "#", " ", "#"],
    ["#", " ", " ", " ", " ", " ", " ", " ", "#"],
    ["#", "#", "#", "#", "#", "#", "#", " ", "#"],
    ["#", " ", " ", " ", " ", " ", " ", " ", "x"],
    ["#", "#", "#", "#", "#", "#", "#", "#", "#"]
]

maze3 = [
    ["#", "o", "#", "#", "#", "#", "#", "#", "#"],
    ["#", " ", " ", " ", "#", " ", " ", " ", "#"],
    ["#", " ", "#", " ", "#", " ", "#", " ", "#"],
    ["#", " ", "#", " ", " ", " ", "#", " ", "#"],
    ["#", " ", "#", "#", "#", "#", "#", " ", "#"],
    ["#", " ", " ", " ", " ", " ", " ", " ", "#"],
    ["#", "#", "#", "#", "#", "#", "#", " ", "#"],
    ["#", " ", " ", " ", " ", " ", " ", " ", "#"],
    ["#", "#", "#", "#", "#", "#", "#", "x", "#"]
]


maze4 = [
    ["#", "#", "#", "#", "#", "#", "#", "#", "#"],
    ["o", " ", " ", " ", "#", " ", " ", " ", "#"],
    ["#", " ", "#", " ", "#", " ", "#", " ", "#"],
    ["#", " ", "#", " ", " ", " ", "#", " ", "#"],
    ["#", " ", "#", "#", "#", "#", "#", " ", "#"],
    ["#", " ", " ", " ", " ", " ", " ", " ", "#"],
    ["#", "#", "#", "#", "#", "#", "#", " ", "#"],
    ["#", " ", " ", " ", " ", " ", " ", " ", "x"],
    ["#", "#", "#", "#", "#", "#", "#", "#", "#"]
]


maze5 = [
    ["#", "#", "#", "#", "#", "#", "#", "#", "#"],
    ["#", " ", " ", " ", "#", " ", " ", " ", "o"],
    ["#", " ", "#", " ", "#", " ", "#", " ", "#"],
    ["#", " ", "#", " ", " ", " ", "#", " ", "#"],
    ["#", " ", "#", "#", "#", "#", "#", " ", "#"],
    ["#", " ", " ", " ", " ", " ", " ", " ", "#"],
    ["#", "#", "#", "#", "#", "#", "#", " ", "#"],
    ["#", " ", " ", " ", " ", " ", " ", " ", "#"],
    ["#", "#", "#", "#", "#", "#", "#", "x", "#"]
]

maze6 = [
    ["#", "#", "#", "#", "#", "#", "#", "#", "#"],
    ["o", " ", " ", " ", "#", " ", " ", " ", "#"],
    ["#", " ", "#", " ", "#", " ", "#", " ", "#"],
    ["#", " ", "#", " ", " ", " ", "#", " ", "#"],
    ["#", " ", "#", "#", "#", "#", "#", " ", "#"],
    ["#", " ", " ", " ", " ", " ", " ", " ", "#"],
    ["#", "#", "#", "#", "#", "#", "#", " ", "#"],
    ["#", " ", " ", " ", " ", " ", " ", " ", "#"],
    ["#", "#", "#", "#", "#", "#", "x", "#", "#"]
]

maze7 = [
    ["#", "#", "#", "#", "#", "#", "#", "#", "#"],
    ["#", " ", " ", " ", "#", " ", " ", " ", "o"],
    ["#", " ", "#", " ", "#", " ", "#", " ", "#"],
    ["#", " ", "#", " ", " ", " ", "#", " ", "#"],
    ["#", " ", "#", "#", "#", "#", "#", " ", "#"],
    ["#", " ", " ", " ", " ", " ", " ", " ", "#"],
    ["#", "#", "#", "#", "#", "#", "#", " ", "#"],
    ["#", " ", " ", " ", " ", " ", " ", " ", "x"],
    ["#", "#", "#", "#", "#", "#", "#", "#", "#"]
]

maze8 = [
    ["#", "#", "#", "#", "#", "#", "#", "#", "#"],
    ["o", " ", " ", " ", "#", " ", " ", " ", "#"],
    ["#", " ", "#", " ", "#", " ", "#", " ", "#"],
    ["#", " ", "#", " ", " ", " ", "#", " ", "#"],
    ["#", " ", "#", "#", "#", "#", "#", " ", "#"],
    ["#", " ", " ", " ", " ", " ", " ", " ", "#"],
    ["#", "#", "#", "#", "#", "#", "#", " ", "#"],
    ["#", " ", " ", " ", " ", " ", " ", " ", "#"],
    ["#", "#", "#", "#", "#", "#", "#", "x", "#"]
]

maze9 = [
    ["#", "#", "#", "#", "#", "#", "#", "#", "#"],
    ["#", " ", " ", " ", "#", " ", " ", " ", "o"],
    ["#", " ", "#", " ", "#", " ", "#", " ", "#"],
    ["#", " ", "#", " ", " ", " ", "#", " ", "#"],
    ["#", " ", "#", "#", "#", "#", "#", " ", "#"],
    ["#", " ", " ", " ", " ", " ", " ", " ", "#"],
    ["#", "#", "#", "#", "#", "#", "#", " ", "#"],
    ["#", " ", " ", " ", " ", " ", " ", " ", "x"],
    ["#", "#", "#", "#", "#", "#", "#", "#", "#"]
]

maze10 = [
    ["#", "#", "#", "#", "#", "#", "#", "#", "#"],
    ["o", " ", " ", " ", "#", " ", " ", " ", "#"],
    ["#", " ", "#", " ", "#", " ", "#", " ", "#"],
    ["#", " ", "#", " ", " ", " ", "#", " ", "#"],
    ["#", " ", "#", "#", "#", "#", "#", " ", "#"],
    ["#", " ", " ", " ", " ", " ", " ", " ", "#"],
    ["#", "#", "#", "#", "#", "#", "#", " ", "#"],
    ["#", " ", " ", " ", " ", " ", " ", " ", "#"],
    ["#", "#", "#", "#", "#", "#", "#", "x", "#"]
]